1111111111111
1000444440001
1014141414101
1044444444401
1414141414141
1444444444441
1414141414141
1444444444441
1414141414141
1044444444401
1014141414101
1000444440001
1111111111111
