1111111111111
1000444440001
1011144411101
1014441444101
1414144414141
1444444444441
1441441441441
1444444444441
1414144414141
1014441444101
1011144411101
1000444440001
1111111111111
