1111111111111
1000444440001
1044114114401
1014444444101
1414441444141
1414441444141
1444144414441
1414441444141
1414441444141
1014444444101
1044114114401
1000444440001
1111111111111
