1111111111111
1000441440001
1041444441401
1011414141101
1444414144441
1441144411441
1144444444411
1441144411441
1444414144441
1011414141101
1041444441401
1000441440001
1111111111111
