############
#      PX O#
#      X####
#      O   #
#######    #
#    ##    #
#    ##    #
#          #
#          #
#       #  #
############